###########################
###########################
##@.........##...........##
##..........##...........##
##..........##...........##
##..........##........#####
##..........##........#####
##.....................$$##
##...............##....$$##
##....#####......##...#####
##....#####......##...#####
##....##.........##......##
##....##*........##......##
###########################
###########################