###########################
###########################
##@.........##...........##
##..........##...........##
##..........##......!....##
##..........##........#####
##..........##........#####
##.....................$$##
##...............##....$$##
##....#####......##...#####
##....#####...!..##...#####
##....##.........##......##
##....##*........##......##
###########################
###########################