###########################
###########################
##@.........##...........##
##..........##...........##
##..........##......!....##
##..........##........#####
##..........##........#####
##......................$$#
##...............##.....$$#
##....#####......##...#####
##....#####...!..##...#####
##....##.........##......##
##....##*........##......##
###########################
###########################