###########################
###########################
##@.##......##......##...##
##..##......##..##..##..!##
##..##..##..##..##..##...##
##..##..##..##..##.......##
##..##..##..##..##..##...##
##..##..##..##..##..##...##
##..##..##..##..##..#######
##..##..##..##..##..#######
##..##..##..##..##..##*..##
##......##......##..##...$$
##......##......##....!..$$
###########################
###########################