###########################
#@........................#
#.........................#
#..####....#######....##..#
#..####....#######....##..#
#..####...................#
#........................$#
#...........###..........$#
#...........###......##...#
#####.......###......##...#
#####..########......##...#
#####..########......##...#
#......########......##...#
#!.....###*..........##!..#
###########################