###########################
#@.......................!#
#.........................#
#..####....#######....##..#
#..####....#######....##..#
#..####...................#
#.........................$
#...........###...........$
#...........###......##...#
#####.......###......##...#
#####..########......##...#
#####..########......##...#
#......########......##...#
#!.....###*..........##!..#
###########################