###########################
###########################
##@.........#######.!....$$
##............####.......$$
##............####.......##
##............####.......##
##......###...####.....####
##......###...####.....####
###.....###............####
###.....###..............##
###.....###..............##
##......###..............##
####....###*..........!..##
###########################
###########################