###########################
###########################
##@.........#######.!..$$##
##............####.....$$##
##............####.......##
##............####.......##
##......###...####.....####
##......###...####.....####
###.....###............####
###.....###..............##
###.....###..............##
##......###..............##
####....###...........!..##
###########################
###########################