###########################
#@.########################
#....######..............##
#....######..............##
##...######..............##
##.......................##
##..........##...........##
##..........##...........##
##..........#######......##
##.....############......##
##.....#######...........$#
##..........##..........!$#
##........!*##...........##
###########################
###########################